0000000000000\000000000000000000/00000000000000
0000_________))0000000000000000((__________0000
000/.-------./\\0000\0000/0000//\.--------.\000
00//#######//##\\000))00((000//##\\########\\00
0//#######//###((00((0000))00))###\\########\\0
((#######((#####\\00\\00//00//#####))########))
0\##'0`###\######\\00\)(/00//######/####'0`##/0
00)'0000``#)'00`##\`->oo<-'/##'00`(#''00000`(00
0000000000(0000000``\`..'/''0000000)00000000000
000000000000000000000\""(0000000000000000000000
0000000000000000000000`- )000000000000000000000
0000000000000000000000/ /0000000000000000000000
000000000000000000000( /\0000000000000000000000
000000000000000000000/\| \000000000000000000000
00000000000000000000(  \00000000000000000000000
000000000000000000000000)0000000000000000000000
00000000000000000000000/00000000000000000000000
0000000000000000000000(000000000000000000000000