00011111000111111100011111000
00111110001111211110001111100
01111110001112321110001111110
11111100001123432110000111111
11111100011123432111000111111
11111100011123432111000111111
11111100011234543211000111111
11111100011234543211000111111
11111100112345654321100111111
11111101112345654321110111111
11111101112345654321110111111
11111101112345654321110111111
11111111123455655432111111111
11111111234566666543211111111
11111112345677877654321111111
11111123456788988765432111111
11111234567899999876543211111
11112345678999999987654321111
11123456789999999998765432111
11234567899999999999876543211
12345678999999999999987654321