55555555555555555555555555555
55555555555555555555555555555
55555555000000000000055555555
55555500000000000000000555555
55555500055555555555000555555
55555500055555555555000555555
55555500055555555555000555555
55555500055555555555000555555
55555555555555555555555555555
55555500055555555555000555555
55555500055555555555000555555
55555500055555555555000555555
55555500055555555555000555555
55555555000000000000055555555
55555555550000000005555555555
55555555555555555555555555555
55555555555555555555555555555
55555555555555555555555555555
55555555555555555555555555555
55555555555555555555555555555
55555555555555555555555555555