1111111111111111111111111111111111111111111111111111111111111111111111111111111111111
1000000000000000011000000000000000000000000000000000000000000000000000000000000000001
1001000000000000001100000000000000000000000000000000000000000000000000000000000000001
1001001000000011111111111100000000000000000000000000000000000000000000000000000000001
1001001000000011111111111100000000000000000000000000011000011001100000000000000000001
1000000100000000000000000000000000000000000000000000011000011001100000000000000000001
1110000100000000000001000000000001110000000000000000000000000000000000000000000000001
1000000000011100011001000000000001110000000000000000000000000000000000000000010000001
1000000000011100011001000000000011100000000000000000000000000000001111111111110000001
1000000000011100000001000000011111111110000001111110000000000000000000000000010000001
1110000000000000000001000000000000000000000001100000000000000000000000000000010000001
1110010000000000000000000000000000000000000001100000000000000000000000000000010011001
1110010000000111111100000000000000000000000001100000000000100000000000000000010011001
1000010000000111111100000000000000000000000000000011111111100000000111111111110011001
1110010001111111111100000000000000000000000000000010000000000000000000000000010000001
1110010001111111111100000000011100111111000000000010000000000000011110000000010000001
1000010001111111111100000000010000000001000000000010000000000000111000000000010000001
1000010001100100110100000000010000000001000111111110000000000000001110000000010000001
1000010000000000100100000000010000000001000100000000001100000000111000000000010000001
1000010000000000000000000000010000000001000100000000011000000000001100000000010000001
1000010000000000000000000000010000000001000100000000110000000000111000000000010000001
1000011111111111111111111111110000000001111100000011000000000000011100000111111111111
1000000110000000000000000000000000000000000000000011000000000001111000000000000000001
1000000110000000000000000000000000000000000000000001100000000000011100000000000000001
1000000011000000000000000000000000000000000000000000111000000000001110000000000000001
1000000001100000001111111110000000000000000000000000001000000000011100000000000000001
1000000011000000000000111111111100000000000000000000001000000000000000000000000000001
1000000001100001110000000001111111100000000000000000001000000000000000000000000000001
1000000011000000011110000000000011111111100000000000001000000000011111111111000000001
1000000001100000000111100000000000011111110000000000001000000000010000000001000000001
1000000000110000000000110011000000000011110000000000001000000000000000000001000000001
1000000000011000000000011110000000000001100000000000001000000000010000000001000000001
1000000000001100000000001100000000000001100000000000001000000000011111111111000000001
1000000000000111111111111111110000000000110000000000000100000000000000000000000000001
1000000000000000000000000000000000000001100000000000001000000000000000000000000000001
1000000000011110000000000000000000000001111111111111111111111111111111000000000000001
1000000001111111100000000000001111110001100000000000000000000000000000000000000000001
1000011111111111111111100000001001100001100000000000000000000000000000000000000000001
100000000011111111111000000000100100000000000000000000000011100000000000000000000001
1000000001111111110000000000001000000000000000000000000000011100000000000000000000001
1000000000111110000000000001111111111111111111111111111111111100000000000000000000001
1000000000011000000000000000000000000000111111111111111111111111111111111111000000001
1000000000000000000000000000000000000000000000000000000000011111111111111110000000001
1000000000000000000000000000000000000000000000000000000000000000000000000000000000001
1000000000000000000000000000000000000000000000000000000000000000000000000000000000001
1111111111111111111111111111111111111111111111111111111111111111111111111111111111111
