1111111111111111111111111111111111111111111111111111111111111111111111111111111111111
1000000000000000011000000000000000000000000000000000000000000000000000000000000000001
1001000000000000001100000000000000000000000000000000000000000000000000000000000000001
1001001000000011111111111100000000000002222220000000000000000000000000000000000000001
1001001000000011111111111100000000000000222200000000011000011001100000000000000000001
1000000100000000000000000000000000000000222000000000011000011001100000000000000000001
1110000100000000000001000000000002220000220000000000000000000000000000000000000000001
1000000000011100011001000000000002220000000000000000000000000000000000000000010000001
1000000000011100011001000000000022200000000000000000000000000000001111111111110000001
1000000000011100000001000000022222222220000002222220000000000000000000000000010000001
1110000000000000000001000000000000000000000001100000000000000000000000000000010000001
1110010000000000000000000000000000000000000001100000000000000000000000000000010011001
1110010000000111111100000000000000000000000001100000000000100000000000000000010011001
1000010000000111111100000000000000000000000000000011111111100000000111111111110011001
1110010001111111111100000000000000000000000000000010000000000000000000000000010000001
1110010001111111111100000000022200222222000000000010000000000000011110000000010000001
1000010001111111111100000000010000000001000000000010000000000000111000000000010000001
1000010001100100110100000000010000000001000111111110000000000000001110000000010000001
1000010000000000100100000000010000000001000100000000001100000000111000000000010000001
1000010000000000000000000000010000000001000100000000011000000000001100000000010000001
1000010000000000000000000000010000000001000100000000110000000000111000000000010000001
1000011111111111111111111111110000000001111100000011000000000000011100000111111111111
1000000110000000000000000000000000000000000000000011000000000001111000000000000000001
1000000110000000000000000000000000000000000000000001100000000000011100000000000000001
1000000011000000000000000000000000000000022222000000111000000000001110000000000000001
1000000001100000001111111110000000000000002222200000001000000000011100000000000000001
2000000022000000000000222222222200000000000222000000002000000000000000000000000000002
2000000002200002220000000002222222200000000020000000002000000000000000000000000000002
2000000022000000022220000000000022222222200000000000002000000000022222222222000000002
2000000002200000000222200000000000022222220000000000002000000000020000000002000000002
2000000000220000000000220022000000000022220000000000002000000000000000000002000000002
2000000000022000000000022220000000000002200000000000002000000000010000000001000000001
1000000000001100000000001100000000000001100000000000001000000000011111111111000000001
1000000000000111111111111111110000000000110000000000000100000000000000000000000000001
1000000000000000000000000000000000000001100000000000001000000000000000000000000000001
1000000000011110000000000000000000000001111111111111111111111111111111000000000000001
1000000001111111100000000000001111110001100000000000000000000000000000000000000000001
1000011111111111111111100000001001100001100000000000000000000000000000000000000000001
1000000000111111111110000000001001000000000000000000000000111000000000000000000000001
1000000001111111110000000000001000000000000000000000000000011100000000000000000000001
1000000000111110000000000002222222222222222222222222222222222200000000000000000000002
2000000000022000000000000000000000000000222222222222222222222222222222222222000000002
2000000000000000000000000000000000000000000000000000000000022222222222222220000000001
1000000000000000000000000000000000000000000000000000000000000000000000000000000000001
1000000000000000000000000000000000000000000000000000000000000000000000000000000000001
1111111111111111111111111111111111111111111111111111111111111111111111111111111111111